#####
#  @#
# BB# ###
# B # #*#
### ###*#
 ##    *#
 #   #  #
 #   ####
 #####
