 ####
##  #
# @B#
##B ##
## B #
#*B  #
#**X*#
######