 ####
 #@ ###
 # B  #
### # ##
#*# #  #
#*B  # #
#*   B #
########