  ######
  #    #
###BBB #
#@ B** #
# B***##
####  #
   ####