  #####
###  @#
#  B* ##
#  *B* #
### XB #
  #   ##
  #####